NO ./textures/wood1_small.xpm
SO ./textures/wood_boards.xpm
WE ./textures/green_tiles.xpm
EA ./textures/bw_tiles.xpm
F 130,200,100
C 65,195,230


11111111111111111111
10000000000000000001
10001111000001100001
1000000000S000000001
10000000000000000001
10000000000000110001
10001111000000110001
10000000000000000001
10001100011001000001
10001100000001000001
10000000000000000001
10010000111111110001
10010000000000000001
10000000000000000001
11111111111111111111