NO ./textures/wood1_small.xpm
SO ./textures/wood_boards.xpm
WE ./textures/green_tiles.xpm
EA ./textures/bw_tiles.xpm
F 130,200,0
C 65,195,230


11111111111111111111
10001000000000000001
10S01000000000010001
10001001111100010001
10001001000000000001
10001001000000000001
10001111000111100001
10000000000100000001
10001111111100000001
10000000000000110001
11111000000000000001
10001111100011110001
10000000000010000001
10000000000010000001
11111111111111111111