NO ./textures/wood1_small.xpm
SO ./textures/wood_boards.xpm
WE ./textures/green_tiles.xpm
EA ./textures/bw_tiles.xpm
F 130,200,100
C 65,195,230


11111111111111111111
10000000000000000001
10000000000000000001
1000000000S000000001
10000000000000000001
10000000000000000001
10001111000000000001
10000000000000000001
10000000000000000001
10000000000000000001
10000000000000000001
10000000000000000001
10000000000000000001
10000000000000000001
11111111111111111111