NO ./textures/green_bricks.xpm
SO ./textures/red_bricks.xpm
WE ./textures/wood1_small.xpm
EA ./textures/green_tiles.xpm
F 130,150,120
C 65,255,200
        1111111111111111111111111
        1000000000110000000000001
        1011000001110000000000001
        1001000000000000000000001
111111111011000001110000000000001
100000000011000001110111111111111
11110111111111011100000010001
11111111111111111111111111111

11111111111111111111111111111
111101111111111111E010011111
1100000011011    10010001
1000000000001111110010001
10000000000000001101010011111
1100000111010101111101111000111
11110111 1110101 101111010001
11111111 1111111 111111111111