NO ./textures/green_bricks.xpm
SO ./textures/red_bricks.xpm
WE ./textures/hedge_text2.xpm
EA ./textures/wood_text2.xpm
F 130,200,0

C 65,195,230


11111111111111111111111111111111
10000000000000000000000000000001
10000000000000000000000000000001
10000000000000000000000000000001
1000000000000000000000S000000001
10000000000000000000000000000001
10000000000000000000000000000001
10000000000000000000000000000001
10000000000000000000000000000001
10000000000000000000000000000001
10000000000000000000000000000001
10000000000000000000000000000001
11111111111111111111111111111111