


WE ./textures/wood1.xpm
NO ./textures/book.xpm
F 140,90,50

C 150,150,150
EA ./textures/wood2.xpm

SO ./textures/door.xpm

11111111111111111111111111111111
10000000000000000000000000000001
10000000000000000000000000000001
10000000000000000000000000000001
1000000000000000000000S000000001
10000000000000000000000000000001
10000000000000000000000000000001
10000000000000000000000000000001
10000000000000000000000000000001
10000000000000000000000000000001
10000000000000000000000000000001
10000000000000000000000000000001
11111111111111111111111111111111