
F 130,200,0

C 65,195,230


NO ./textures/green_tiles.xpm
SO ./textures/wood_boards.xpm
WE ./textures/bw_tiles.xpm
EA ./textures/wood1_small.xpm



1111111111111111111111111
100000000E000000000000001
1000000000110000001111111
111111111111111111
1111111       1111