

WE ./path_to_the_west_texture

NO ./path_to_the_north_texture
F 220,100,0
EA ./path_to_the_east_texture


SO ./path_to_the_south_texture
C 225,30,0





1111111111111111111111111
1000000000110000000000001
 1100000001110000000000011
   1001000000000000000000111
111111111011000001110000000111111
100000111111111001110100000000001
1111011       1111011100000011111
1111011       111101010010001
11000011111111111100000010001
10000000000000001100000010001
10000000000000001101010010001
11000001110101011111011110W01
11110111 1110101 101111010001
11111111 1111111 111111111111
