
F 130,200,0
C 65,20,230

NO             ./textures/wood1_small.xpm
SO ./textures/wood_boards.xpm


WE ./textures/green_tiles.xpm
EA ./textures/bw_tiles.xpm



1111111111111111111111111
100000000E000000000000001
1000000000110000001111111
111111111111111111
1111111       1111